NO ./images/wall1.png
SO ./images/wall1.png
WE ./images/wall1.png
EA ./images/wall1.png
F 25,25,25
C 128,17,17





1111111111111111111111111
1000000000110000000000001
1011000001110000000000001
100100000000000000000000111111111
111111100011000001110000000000001
100000000011000001110111111111111
1100000000000000000000010001
110100W000100000001010010001
11000000100001011100000010001
10000001110000001100000010001
1000000000000001101010010001
11111111101010111110111100111
1111011101110101 101111010001
1111111111111111 111111111111