NO ./images/wall1.png
SO ./images/wall1.png
WE ./images/wall1.png
EA ./images/wall1.png
F 25,25,25
C 128,17,17



11111111111111111111111111111111111111111111111111111
10010000000000000D00000000000D000000000000000000000001
1000000000000000010111111111110000000000001000000000001
 111000000000000001           10010000100100100100010001
    1001D1000000001            1001000010000000D0100011
 111000000000000010111111       10010000100N0101010001
10000100011D11100D00000001       10010000100100010001
 1111000000000000100000001        10010001D100010001
     100111D1110000011111          1001000000010001
 1111000000000000001                11010000010001
10000100011D11100001                 100100010001
 111000000000000000111111             1000000001
    100000000000010000001              1111D111
11110000001000000000000001111111111111110000000111111111
10000000111110000010000000D000000000000000000000000000001
 1110000000000000011111111111110000100000000011100000001
    10001D100000001            100000011D11000000000001
 111000000000000000111111       1000000000000000000001
10000100001111000000000001       100110000111D1100001
 1111000000000000100000001        100000000000000001
     10001100000000011111          1111111D11111111
 1111000000111111D11                10000000000001
10000100000000000001                 100001111001
 111000000111100000111111             1000000001
    100000000000010000001              10010001
     1111111111111111111                100001
                                         1111
                                         1111