NO ./images/wall1.png
SO ./images/wall1.png
WE ./images/wall1.png
EA ./images/wall1.png
F 25,25,25
C 128,17,17






1111111111111111111111111
1000000000110000000000001
1011000001110000000000001
100100000000000000000000111111111
1111111D1011000001110000000000001
100000000011000001110111111111111
11D1000000D000011100000010001
11D10000001000011101010010001
11000000100001011100000010001
10000001110000001100000010001
10000000N0000001101010010001
110000010001010111110111100111
1111011101110101 101111010001
1111111111111111 111111111111